11111111111111111111111111111
1P000000000011000000000000001
10000000000011000001111100001
10000000000000000000000100001
10000000000000000000000100001
10000000001111100000000100001
10000000000000100000000100001
10000000000000100000000100001
1000000C100000010000000100C01
10000000000000100000000100001
1000C000100C10000010000C00001
10000000000000000000000100001
10000000000000000000000100001
10000000000000000000000100001
100000C00000000000000100000E1
11111111111111111111111111111