1111111111111
10000000000E1
1000000000001
1000P00000001
100000000C001
1000000000001
1111111111111