1111111111111
100C00000C0E1
1000000000001
1C00P00000001
10000M000C001
1000000000001
1111111111111