11111111111111111111111111111
10000000000011000000000000001
10000000000011000001111100001
10000000000000000000000100001
10000000000000000000000100001
10000000001111100000000100001
10000000000000100000000100001
10000000000000100000000100001
1000000C100000010000000100C01
100000000000001P0000000100001
1000C000100C10000010000C00001
100000000000011E1100000100001
10000000000001000100000100001
100000000000010C0100000100001
100000C0000001000100010000001
11111111111111111111111111111